
SO ./textures/grass_south.png

NO ./textures/stone_north.png

EA ./textures/brick_east.png

WE ./textures/wood_west.png


C 25,100,233

F 255,100,15


        1111111111111111111111110
        1000000000110000000000001
        1011000001110000000000001
       100100000000N0000000000011
111111111011000001110000000000001
100000000011000001110111111111111
111101111111110111000000100010
11110111111111011101010010001
11000000111010111000000000001
10000000000000011000000100001
10000000000000001101010010001
110000011101010111110111100111
11110111 1110101 111111110001
11111111 1111111 111111111111
