
SO ./textures/grass_south.png

NO ./textures/stone_north.png

EA ./textures/brick_east.png

WE ./textures/wood_west.png



C 25,20,175

F 255,100,200

1111111111111 11111 1111
1000000000000000000100001
1001000000000N00000001111
11111000000000000001000001
11111100000000000001000001
1001000000100000001000001
1001000000000000001000001
1001000000001000001000001
1111111111111111111111111