WE ./textures/wood_west.png

SO ./textures/grass_south.png

NO ./textures/stone_north.png

EA ./textures/stone_north.png


C 25,100,222    

F 255,100,28

1111
10N1
1111
