SO ./textures/grass_south.png

NO ./textures/stone_north.png

EA ./textures/brick_east.png

WE ./textures/wood_west.png


C 25,100,233

F 255,100,15



1111
10N1
1110